111111111111111111111111111111
1C00000000000000000000000000C1
100000000000000000000000000001
100000000000000000000000000001
100000000000000000000000000001
1000000000000000000000000000E1
100000000000000000000000000001
100000000000000000000000000001
100000000000000000000000000001
1C000000000000P0000000000000C1
111111111111111111111111111111