111111
1P0001
10C001
100C01
100001
111111