111111
1100C1
10P001
100001
1000E1
111111